SIZE 10 10 10
VOXEL 0.1

LAYER 0
#........#
..........
..........
..........
..........
..........
..........
..........
..........
#........#

LAYER 1
#........#
..........
..........
..........
..........
..........
..........
..........
..........
#........#

LAYER 2
#........#
..........
..........
..........
..........
..........
..........
..........
..........
#........#

LAYER 3
#........#
..........
..........
..........
..........
..........
..........
..........
..........
#........#

LAYER 4
#........#
..........
..........
..........
..........
..........
..........
..........
..........
#........#

LAYER 5
#........#
..........
..........
..........
..........
..........
..........
..........
..........
#........#

LAYER 6
#........#
..........
..........
..........
..........
..........
..........
..........
..........
#........#

LAYER 7
#........#
..........
..........
..........
..........
..........
..........
..........
..........
#........#

LAYER 8
#........#
..........
..........
..........
..........
..........
..........
..........
..........
#........#

LAYER 9
#.#.#.#.#.
.#.#.#.#.#
#.#.#.#.#.
.#.#.#.#.#
#.#.#.#.#.
.#.#.#.#.#
#.#.#.#.#.
.#.#.#.#.#
#.#.#.#.#.
.#.#.#.#.#
