WWWWWWWWWWWWW
W...........W
W.C.......C.W
W...........W
W...E...E...W
W...........W
W.....C.....W
W...........W
W...E...E...W
W...........W
W.C.......C.W
W.....P.....W
WWWWWWWWWWWWW
