SIZE 10 10 10
VOXEL 0.5

LAYER 0
##########
##########
##########
##########
##########
##########
##########
##########
##########
##########

LAYER 1
G........B
..........
..........
..........
..##..##..
..##..##..
..........
..........
..........
Y........M

LAYER 2
G........B
..........
..........
..........
..##..##..
..##..##..
..........
..........
..........
Y........M

LAYER 3
G........B
..........
..........
..........
..##..##..
..##..##..
..........
..........
..........
Y........M

LAYER 4
G........B
..........
..........
..........
..##..##..
..##..##..
..........
..........
..........
Y........M

LAYER 5
G........B
..........
..........
..........
..........
..........
..........
..........
..........
Y........M

LAYER 6
G........B
..........
..........
..........
..........
..........
..........
..........
..........
Y........M

LAYER 7
G.B.G.B.G.
.B.G.B.G.B
G.B.G.B.G.
.B.G.B.G.B
G.B.G.B.G.
.B.G.B.G.B
G.B.G.B.G.
.B.G.B.G.B
G.B.G.B.G.
.B.G.B.G.B

LAYER 8
Y.M.Y.M.Y.
.M.Y.M.Y.M
Y.M.Y.M.Y.
.M.Y.M.Y.M
Y.M.Y.M.Y.
.M.Y.M.Y.M
Y.M.Y.M.Y.
.M.Y.M.Y.M
Y.M.Y.M.Y.
.M.Y.M.Y.M
