x x x x x x x x x x x x x x x x x b b b b
x x x x x x x x x x x x x x x x x b b b b
x x x p p p p p p p p p p p p p p p p b b
x x p p p p p p p p p p p p p p p p p b b
x x p p p p p p p p p p p p p p p p p x x
x x p p p x x x x x x x x x p p p p p x x
x x p p p x x x x p p p p p p p p p p x x
x x p p p x x x x p p p p p p x p p p x x
x x p p p x x x x p j p p p x x p p p x x
x x p p p x x x p j j j p x x x p p p x x
x x p p p p p p j j j j j p p p p p p x x
x x p p p x x x p j j j p x x x p p p x x
x x p p p x x p p p j p x x x x p p p x x
x x p p p x p p p p p p x x x x p p p x x
x x p p p p p p p p p p x x x x p p p x x
x x p p p p p x x x x x x x x x p p p x x
x x p p p p p p p p p p p p p p p p p x x
a a p p p p p p p p p p p p p p p p p x x
a a p p p p p p p p p p p p p p p p x x x
a a a a x x x x x x x x x x x x x x x x x
a a a a x x x x x x x x x x x x x x x x x
